***X*****X
XX*X*XXX*X
*****X***X
XXXXXXXX*X
*********X
*XXXXXXXXX
***X*****X
XX*X*XXX*X
*****X****
XXXXXXXX**